13
17
N N N N N N N N N N N N N N N N N
N N N N N N N N N N N N N N N N N
N N N N N N N N N N N N N N N N N
N P P P P P P P P P P P P P P P P
N P P P P P P P P P P P P P P P P
N N N N N N N N N N N N N N N N N
N A A A N N N N N S N N N N A A A
N N N N N N N N N N N N N N N N N
N N N N N N N N N N N N N N N N N
N N N N N N N N N N N N N N N N N
N N N N N N N N N N N N N N N N N
N N N N N N N N N N N N N N N N N
N N N N N N N N N N N N N N N N N